  #######################
    #       #   # # #   #
# ### ##### # ### # # # #
# #     # #     # # # # #
# # ##### ####### # ### #
#   # #   # #   # #     #
### # # ### # # # # ### #
#     #       #     #   #
##### # # ### ##### ### #
# #     #   #   # # #   #
# ######### ### # ### # #
#           #     # # # #
##### ### # # # # # ### #
# # # #   # # # # #     #
# # # # # ### ### ##### #
#     # #   #   # #     #
### ####### ### #########
#     #   # # # # #   # #
####### ### # # # ### # #
#   #     #   # #   # # #
# # # # # # # ### ### # #
# # # # #   #           #
### # ### # # # # ### # #
#     #   # # # # #   #  
#######################  
