  ###################
                #   #
# # ##### ####### # #
# #   #   #       # #
### ####### # ### ###
# #   #   # #   #   #
# ### # ######### # #
#             #   # #
# ### ########### ###
#   #           #   #
### ### # ### # ### #
#     # #   # #     #
# ### ### ####### # #
#   #   #   # # # # #
##### ####### # ### #
#     # # # #       #
# ### # # # ### #####
# # #       # #     #
# # ### ##### # # ###
# #     #       #    
###################  
