  #########
    #     #
# ### # # #
#     # # #
# ### # ###
#   # # # #
# # ##### #
# # # # # #
# ### # # #
#          
#########  
