   ##########################################################
               #  #        #  #           #     #     #     #
#  ##########  #  #  ####  #  ####  ####  #  #######  ####  #
#        #              #     #        #        #           #
#  #######  ####  #  #  ################  #  #  #  #######  #
#  #     #  #  x  #  #  #              #  #  #  #     #  #  #
#  ####  ################  #  #  #  ####  #############  #  #
#     #     #  #  #     #  #  #  #  #  #  #     #  #     #  #
####  #  #  #  #  #  #  ####  ####  #  #  #  ####  ####  #  #
#        #        #  #  #     #  #  #  #        #  #  #     #
#  ####  ##########  #  #  ####  ####  #  #######  #  #  ####
#  #           #     #     #     #     #        #     #     #
####  ####  ####  #######  #  ####  #  #  ####  #  ####  ####
#     #  #  #  #  #                 #        #     #  #     #
#  ####  ####  #  ####  #######  #  ####  #######  #  ####  #
#  #  #  #     #  #     #     #  #  #        #     #  #  #  #
#  #  #  ####  ####  #  ####  #  #  ####  ####  ####  #  #  #
#     #        #     #  #        #     #  #              #  #
#  #  #  ####  #  #  #  ####  #######  ####  #  ##########  #
#  #     #        #  #  #        #     #     #     #  #     #
#  #  #  ####  ####  #######  ####  ####  #######  #  #  #  #
#  #  #  #        #  #  #     #     #     #  #        #  #  #
#  #######  #  ####  #  #  ################  #############  #
#  #     #  #     #     #           #     #     #        #  #
#  #  #  #  #############  #  #######  ####  ####  #  #  #  #
#  #  #  #        #  #  #  #  #              #     #  #     #
#  ####  ####  ####  #  #  ####  #######  #######  #######  #
#     #                 #  #     #        #        #     #  #
####  #######  #######  ################  ####  ####  ####  #
#     #     #     #  #  #        #              #        #  #
#  ####  ##########  #  ####  ##########  #############  ####
#     #        #        #        #           #  #  #  #     #
#  ####  #  ####  ##########  #######  #######  #  #  ####  #
#        #     #     #  #        #  #        #     #     #  #
#######  ####  #######  #  #  #  #  #######  ####  ####  #  #
#        #  #  #        #  #  #  #  #  #     #        #  #  #
#######  #  ####  #  #  #######  #  #  #  ####  #  ####  #  #
#        #  #     #  #  #           #  #        #  #     #  #
####  #  #  #  #  ####  #######  #  #  ####  ####  #  ####  #
#     #        #  #              #              #           #
#############################################################
