  ########
  #   #  #
#        #
# # ###  #
#        #
#  # #  ##
#    ### #
#  #     #
#    #    
########  
